####################
#@......s..........#
#..B...............#
#.......B..........#
#..........q.......#
#..s......q....M...#
#..............C...#
####################